XXXXXXXXXXXXX
XE__________X
X_XXXXX_XXX_X
X_____X_____X
XXXX_XX_XXXXX
X_O_____O___X
X_X_XXXXX_X_X
X___X___X___X
XXX_X_O_X_XXX
X_______X___X
X_XXXXXXX_X_X
X_________O_X
X_XXXXX_XXX_X
X______S____X
XXXXXXXXXXXXX